MM1A|[M124]批处理进行中|
MM1B|[F705]主机系统尚未开启|
MM1C|[M930]该交易已关闭|
MM14|帐户已销户|

MM0e|卡交易必定是无折交易!!![请注意无折标志]|
MM0f|卡交易必定是无折交易!!![请注意无折标志]|
MM0g|还有无折记录!!![请先补登无折]|
MM0h|还有无折记录!!![请先补登无折]|

MM0j|活期一本通!!![请输入客户类型]|

MM0r|系统正在进行批量处理，请稍候|
MM45|你的存折交易次数超过60次，请到银行换发新存折|
MMGH|未知错误|
MMQ0|帐户类型不符|
MMQ1|帐户号类型不符|
MMQ2|不能对此类帐户做此类交易|
MMQ3|该帐户不能冲正|
MMQ4|修改一本通记录失败|
MMQ5|冲正标志不一致|
MMQ6|该交易不能冲正|
MMQ7|冲正数据检查有误不能冲正|
MMQ8|冲正金额有误,不能冲正|
MMQ9|该客户不存在|
MMQA|资料不存在|
MMQB|该帐户不存在|
MMQC|记录不存在|
MMQD|该货币码不存在|
MMQE|此帐户资料不存在|
MMQF|该利率码不存在|
MMQG|此交易资料不存在|
MMQH|相关利率码不存在|
MMQI|无此客户|
MMQJ|该客户已存在|
MMQK|无此帐户|
MMQL|无相应帐户资料或帐号错误|
MMQM|无此交易记录|
MMQN|无帐户信息资料|
MMQO|存期或存种不符|
MMQP|存期不正确|
MMQQ|尚有帐户未销,不可删除|
MMQR|此帐户有余额,不得关闭|
MMQS|尚有利息未清|
MMQT|系统尚未起动|
MMQU|记录已经存在|
MMQV|金额不符|
MMQW|状态不符,不能作此交易|
MMQX|起存金额不足|
MMQY|同种货币不能做此交易|
MMQZ|交易帐号与转帐帐号的货币不同|
MMR0|请输入一个交易帐号|
MMR1|利率码无效|
MMR2|入帐不成功|
MMR3|余额不足|
MMR4|数据有错|
MMR5|状态不对不能入帐|
MMR6|无此币别找零单位|
MMR7|输入有错,金额不足|
MMR8|输入的收回金额大于记录中的交易金额|
MMR9|输入帐户的联机余额小于交易金|
MMRA|帐号输入错误|
MMRB|该帐户未办理存单/折挂失|
MMRC|该帐户已存在|
MMRD|该客户尚有帐户未销|
MMRE|该帐户已销户|
MMRF|该帐户已临时挂失|
MMRG|该帐户已正式挂失|
MMRH|该帐户已冻结|
MMRI|余额已小于最低限额|
MMRJ|此客户已关闭|
MMRK|此一本通号不存在|
MMRL|此一本通已销|
MMRM|此一本通已挂失|
MMRN|发生额已小于最低限额|
MMRO|帐号类型有误|
MMRP|帐户余额不足|
MMRQ|修改失败,请查询此笔交易|
MMRR|现钞不能交换|
MMRS|本业务只限人民币|
MMRT|签发日期不符|
MMRU|密码不符|
MMRV|输入数据有误,请查正或联系电脑人员|
MMRW|帐户类型与计息标记不符|
MMRX|系统日期不对|
MMRY|帐户有误|
MMRZ|帐户状态不符|
MMS0|本存种不允许作外币|
MMS1|无此费率码|
MMS2|查询笔数大于总笔数|
MMS3|查询笔数小于总笔数|
MMS4|密码不符|
MMS5|货币码转换错误,请检查输入的货币码|
MMS6|此功能暂时不能使用|
MMS7|参数有误|
MMS8|数据库操作错误|
MMS9|币别不符|
MMSA|无折笔数为零,无须补登|
MMSB|交易已被冲正,不能再冲正|
MMSC|帐户余额为零|
MMSD|密码有误|
MMSE|两次密码输入不一致|
MMSF|密码修改失败|
MMSG|数据库连接有误|
MMSH|数据库操作错误|
MMSI|该应用系统不存在|
MMSJ|系统其它错误|
MMSK|系统状态错误|
MMSL|交易代码类型错|
MMSM|断线前已处理成功|
MMSN|余额不够|
MMSO|利率不存在|
MMSP|无个人外汇买卖牌价|
MMSQ|查询活期利率码失败|
MMSR|查询活期帐户记录失败|
MMSS|查询定期帐户记录失败|
MMST|查询交易流水记录失败|
MMSU|查询通知记录失败|
MMSV|查询无折记录失败|
MMSW|查询零整记录失败|
MMSX|查询保值日期表失败|
MMSY|查询一本通记录失败|
MMSZ|查询一本通附加记录失败|
MMT0|无此活期帐户记录|
MMT1|无此定期帐户记录|
MMT2|无此交易流水记录|
MMT3|此帐户没有通知记录|
MMT4|此帐户没有无折记录|
MMT5|无此帐户零整记录|
MMT6|无此帐户异常状态记录|
MMT7|无此一本通记录|
MMT8|无此一本通附加记录|
MMT9|代收付表中无此记录|
MMTA|代收付索引表中无此记录|
MMTB|增加活期帐户记录失败|
MMTC|增加定期帐户记录失败|
MMTD|增加交易流水记录失败|
MMTE|增加代收付表记录失败|
MMTF|增加一本通记录失败|
MMTG|增加一本通附加记录失败|
MMTH|修改活期帐户记录失败|
MMTI|修改定期帐户记录失败|
MMTJ|修改交易流水记录失败|
MMTK|修改代收付索引表记录失败|
MMTL|修改一本通记录失败|
MMTM|修改一本通附加记录失败|
MMTN|交易日期不能小于开户日|
MMTO|交易日期不能大于系统日|
MMTP|起息日不能大于系统日期|
MMTQ|目前只接受对美元的汇率|
MMTR|交易码不符,不能冲正|
MMTS|交易日期不能小于动户日|
MMTT|冲正支取帐户号类或型不符|
MMTU|一本通折不存在|
MMTV|无电话银行记录|
MMTW|电话银行记录状态修改错|
MMTX|此证券流水号已经使用|
MMTY|货币不符|
MMTZ|非保证金户,不能做此交易|
MMU0|无折笔数超过60笔,请到银行补登无折|
MMU1|查询一卡通失败|
MMU2|一卡通号应为借记卡号|
MMU3|帐号金额不对|
MMU4|交易类型不对|
MMU5|交易未开通|
MMU6|交易已冲正|
MMU7|冲正交易查询|
MMU8|SBS系统流水记录找不到|
MMU9|无此卡号|
MMUA|抱歉,找不到此借记卡号|
MMUB|此帐户在帐户余额历史文件中不存在|

MMUD|计息方法未建立先/利率未找到,计息失败|
MMUE|此卡已被关户|
MMUF|此记录不能删除|
MMUG|此记录不能修改|
MMUH|货币与卡类名不相配|
MMUI|此卡不能使用|
MMUJ|存单号不能为空|
MMUK|存单号错误|

MMUM|存单号已存在|

MMUS|输入的存期与存单存期不符|

MMUV|提取金额不能大于存单金额|
MMUW|操作数据库失败|
MMUX|记录不存在|
MMUY|卡号不存在|
MMUZ|帐户状态不符|
MMV0|记录状态不符,不能做此交易|
MMV1|记录增加失败|
MMV2|记录修改失败|
MMV3|记录删除失败|
MMV4|输入资料错|
MMV5|卡状态不正常|
MMV6|密码错误|
MMV7|该卡的帐户已销户|
MMV8|该卡的帐户为预销户状态|
MMV9|转账失败|

MMVC|该卡不存在 |
MMVD|记录已存在|
MMVE|起始日期不能大于终止日期|
MMVF|终止日期不能大于当前日期|
MMVG|取费率信息失败|
MMVH|输入错误|
MMVI|数据库操作失败,交易写入系统错误|
MMVJ|卡号非法|
MMVK|账号不存在|
MMVL|记录交易流水失败|
MMVM|查找保证金失败|
MMVN|保证金金额不足|
MMVO|冲正数据卡号错|
MMVP|冲正数据效期错|
MMVQ|冲正数据收费类型错|
MMVR|账户状态不正常|
MMVS|客户号产生错误|

MMVV|交易已被冲正,不能再冲正|
MMW1|输入错误!!![请输入黄金的交易金额]|

MMW4|输入错误!!![请检查客户类型]|
MMW5|卡交易必定是无折交易!!![请注意无折标志]|
MMW6|卡交易必定是无折交易!!![请注意无折标志]|
MMW7|还有无折记录!!![请先补登无折]|
MMW8|还有无折记录!!![请先补登无折]|

MMWA|活期一本通!!![请输入客户类型]|
MMWB|余额错误!!![剩余金额太少，可选择一起卖出]|


MMWI|系统正在进行批量处理，请稍候|
MMY0|跨省交易不能办理|
MMY1|此机构的省行机构号未找到|

MMY4|卡交易必定是无折交易!请注意无折标志|
MMY5|请输入客户类型|
MMY6|余额错误!剩余金额太少，可选择一起卖出|
MMY7|LINK外围系统错误|
MMY8|您无权查询柜员的传票信息|
MMY9|此帐户今日发生额 + 上日余额与当日余额不符 , 请迅速查错|
MMYA|批处理时间 , 此帐户今日发生额 + 上日余额与当日余额不符|
