c=3G%20and%20GPRS%20news	3G and GPRS news	3G	Technology
c=3M%20news	3M news	3M	Companies
c=ASP%20news	ASP news	ASP	Technology
c=ATT%20news	ATT news	AT&amp;T	Companies
c=Accounting%20news	Accounting news	Accounting	Industry
c=Advertising%20industry%20news	Advertising industry news	Advertising	Business: media
c=Aerospace%20and%20defense%20industry%20news	Aerospace and defense industry news	Defense	Industry
c=Afghanistan%20news	Afghanistan news	Afghanistan	Regional
c=Africa%20news	Africa news	Africa	Regional
c=Agriculture%20news	Agriculture news	Agriculture	Industry
c=Airline%20industry%20news	Airline industry news	Airline	Industry
c=Alcoa%20news	Alcoa news	Alcoa	Companies
c=Altria%20news	Altria news	Altria	Companies
c=American%20Express%20news	American Express news	American Express	Companies
c=Argentina%20news	Argentina news	Argentina	Regional
c=Arts%20and%20culture%20news	Arts and culture news	Arts and culture	Entertainment
c=Asia%2DPacific%20latest	Asia-Pacific latest	Asia-Pacific latest	Regional
c=Atlanta%20news	Atlanta news	Atlanta	US regional
c=Australia%20news	Australia news	Australia	Regional
c=Austria%20news	Austria news	Austria	Regional
c=Automotive%20industry%20news	Automotive industry news	Automotive	Industry
c=Balkans%20news	Balkans news	Balkans	Regional
c=Banking%20news	Banking news	Banking	Finance
c=Bay%20Area%20news	Bay Area news	SF Bay Area	US regional
c=Benelux%20news	Benelux news	Benelux	Regional
c=Biotech%20news	Biotech news	Biotech	Industry
c=Black%20interest%20news	Black interest news	Black interest	Society
c=Blogging%20news	Blogging news	Blog	Internet
c=Boeing%20news	Boeing news	Boeing	Companies
c=Book%20publishing%20news	Book publishing news	Book publishing	Business: media
c=Boston%20news	Boston news	Boston	US regional
c=Brazil%20news	Brazil news	Brazil	Regional
c=Broadcasting%20industry%20news	Broadcasting industry news	Broadcasting	Business: media
c=CRM%20news	CRM news	CRM	Business: general
c=Cable%20industry%20news	Cable industry news	Cable	Business: media
c=Canada%20news	Canada news	Canada	Regional
c=Cancer%20news	Cancer news	Cancer	Science
c=Caribbean%20news	Caribbean news	Caribbean	Regional
c=Caterpillar%20Inc%20news	Caterpillar Inc news	Caterpillar Inc	Companies
c=Caucasus%20news	Caucasus news	Caucasus	Regional
c=Central%20Asia%20news	Central Asia news	Central Asia	Regional
c=Charities%20news	Charities news	Charities	Society
c=Chemicals%20industry%20news	Chemicals industry news	Chemicals	Industry
c=Chicago%20news	Chicago news	Chicago	US regional
c=China%20news	China news	China	Regional
c=Citigroup%20news	Citigroup news	Citigroup	Companies
c=Cleveland%2DAkron%20news	Cleveland-Akron news	Cleveland-Akron	US regional
c=Clothing%20industry%20news	Clothing industry news	Clothing	Industry
c=Coca%2DCola%20news	Coca-Cola news	Coca-Cola	Companies
c=Commodities%20news	Commodities news	Commodities	Finance
c=Communications%20equipment%20news	Communications equipment news	Comms. equipment	Technology
c=Computer%20games%20news	Computer games news	Computer games	Technology
c=Computer%20security%20news	Computer security news	Computer security	Technology
c=Computer%20services%20news	Computer services news	Computer services	Technology
c=Construction%20news	Construction news	Construction	Industry
c=Consumer%20durables%20news	Consumer durables news	Consumer durables	Industry
c=Consumer%20electronics%20news	Consumer electronics news	Consumer electro	Industry
c=Consumer%20non%2Ddurables%20news	Consumer non-durables news	Consumer non-durables	Industry
c=Consumer%3A%20book%20reviews	Consumer: book reviews	Book reviews	Entertainment
c=Consumer%3A%20fashion%20news	Consumer: fashion news	Fashion	Lifestyle
c=Consumer%3A%20fitness%20news	Consumer: fitness news	Fitness	Lifestyle
c=Consumer%3A%20food%20and%20drink%20news	Consumer: food and drink news	Food and drink	Lifestyle
c=Consumer%3A%20health%20news	Consumer: health news	Health	Lifestyle
c=Consumer%3A%20home%20and%20garden%20news	Consumer: home and garden news	Home and garden	Lifestyle
c=Consumer%3A%20mens%20news	Consumer: mens news	Men	Lifestyle
c=Consumer%3A%20natural%20health%20news	Consumer: natural health news	Natural health	Lifestyle
c=Consumer%3A%20outdoor%20recreation%20news	Consumer: outdoor recreation news	Outdoor recreation	Lifestyle
c=Consumer%3A%20parenting%20news	Consumer: parenting news	Parenting	Lifestyle
c=Consumer%3A%20seniors%20news	Consumer: seniors news	Seniors	Lifestyle
c=Consumer%3A%20top%20stories	Consumer: top stories	Top consumer	Top stories
c=Consumer%3A%20travel%20news	Consumer: travel news	Travel	Lifestyle
c=Consumer%3A%20womens%20news	Consumer: womens news	Women	Lifestyle
c=Cool%20sites	Cool sites	Cool sites	Internet
c=Corporate%20finance%20news	Corporate finance news	Corporate finance	Finance
c=Corporate%20governance%20news	Corporate governance news	Corporate governance	Finance
c=Crime%20and%20punishment%20news	Crime and punishment news	Crime	Society
c=Cuba%20news	Cuba news	Cuba	Regional
c=Cyberculture%20news	Cyberculture news	Cyberculture	Internet
c=Czech%20Republic%20and%20Slovakia%20news	Czech Republic and Slovakia news	Czech Rep. &amp; Slovakia	Regional
c=DC%20area%20news	DC area news	DC area	US regional
c=Dallas%2DFort%20Worth%20news	Dallas-Fort Worth news	Dallas	US regional
c=Database%20industry%20news	Database industry news	Database	Technology
c=Denver%2DBoulder%20news	Denver-Boulder news	Denver-Boulder	US regional
c=Derivatives%20news	Derivatives news	Derivatives	Finance
c=Detroit%20news	Detroit news	Detroit	US regional
c=Developer%20news	Developer news	Developer	Technology
c=Digital%20television%20news	Digital television news	Digital television	Business: media
c=Domain%20name%20news	Domain name news	Domain name	Internet
c=Drinks%20and%20beverages%20industry%20news	Drinks and beverages industry news	Drink and beverage	Industry
c=DuPont%20news	DuPont news	DuPont	Companies
c=E%2Dcommerce%20news	E-commerce news	E-commerce	Internet
c=EU%20integration%20news	EU integration news	EU integration	Society
c=Eastern%20Europe%20news	Eastern Europe news	Eastern Europe	Regional
c=Eastman%20Kodak%20news	Eastman Kodak news	Eastman Kodak	Companies
c=Economics%20news	Economics news	Economics	Society
c=Emerging%20markets%20news	Emerging markets news	Emerging markets	Finance
c=Engineering%20news	Engineering news	Engineering	Industry
c=Enterprise%20computing%20news	Enterprise computing news	Enterprise	Technology
c=Entertainment%3A%20TV%20shows%20news	Entertainment: TV shows news	Entertainment: TV shows	Entertainment
c=Entertainment%3A%20film%20previews	Entertainment: film previews	Entertainment: film previews	Entertainment
c=Entertainment%3A%20general%20news	Entertainment: general news	Entertainment: general	Entertainment
c=Entertainment%3A%20gossip	Entertainment: gossip	Entertainment: gossip	Entertainment
c=Entertainment%3A%20movie%20news	Entertainment: movie news	Movie news	Entertainment
c=Entertainment%3A%20movie%20reviews	Entertainment: movie reviews	Movie reviews	Entertainment
c=Entrepreneur%20news	Entrepreneur news	Entrepreneur	Business: general
c=Environment%20news	Environment news	Environment	Science
c=Equity%20markets%20news	Equity markets news	Equity markets	Finance
c=Europe%20media%20news	Europe media news	Europe media	Business: media
c=Europe%20news	Europe news	Europe	Regional
c=European%20business%20news	European business news	European business	Business: general
c=Exxon%20Mobil%20news	Exxon Mobil news	Exxon Mobil	Companies
c=Fed%20watch	Fed watch	Fed watch	Finance
c=Firearms%20industry%20news	Firearms industry news	Firearms	Industry
c=Fixed%20income%20news	Fixed income news	Fixed income	Finance
c=Food%20industry%20news	Food industry news	Food	Industry
c=Forex%20markets%20news	Forex markets news	Forex markets	Finance
c=France%20news	France news	France	Regional
c=Fund%20management%20news	Fund management news	Fund management	Finance
c=GMO%20news	GMO news	GMO	Science
c=Gaming%20news	Gaming news	Gaming	Industry
c=Gay%20news	Gay news	Gay	Society
c=General%20Electric%20Company%20news	General Electric Company news	General Electric Company	Companies
c=General%20Motors%20news	General Motors news	General Motors	Companies
c=Genetics%20news	Genetics news	Genetics	Science
c=Germany%20news	Germany news	Germany	Regional
c=Graphics%20industry%20news	Graphics industry news	Graphics industry	Technology
c=Greece%20news	Greece news	Greece	Regional
c=Handhelds%20news	Handhelds news	Handhelds	Technology
c=Healthcare%20management%20news	Healthcare management news	Health management	Industry
c=Hewlett%2DPackard%20news	Hewlett-Packard news	Hewlett-Packard	Companies
c=Home%20Depot%20news	Home Depot news	Home Depot	Companies
c=Honeywell%20International%20news	Honeywell International news	Honeywell International	Companies
c=Hospitality%20industry%20news	Hospitality industry news	Hospitality	Industry
c=Houston%20news	Houston news	Houston	US regional
c=Human%20resources%20news	Human resources news	Human resources	Business: general
c=Human%20rights%20news	Human rights news	Human rights	Society
c=Hungary%20news	Hungary news	Hungary	Regional
c=IBM%20news	IBM news	IBM	Companies
c=IP%20and%20patents%20news	IP and patents news	IP &amp; patents	Business: general
c=IPO%20news	IPO news	IPO	Finance
c=Imaging%20equipment%20news	Imaging equipment news	Imaging equipment	Technology
c=India%20news	India news	India	Regional
c=Indian%20subcontinent%20news	Indian subcontinent news	Indian subcontinent	Regional
c=Indonesia%20news	Indonesia news	Indonesia	Regional
c=Insurance%20industry%20news	Insurance industry news	Insurance	Industry
c=Intel%20news	Intel news	Intel	Companies
c=International%20Paper%20Company%20news	International Paper Company news	International Paper Company	Companies
c=International%20development%20news	International development news	International development	Society
c=International%20relations%20news	International relations news	International relations	Society
c=Internet%20Europe%20news	Internet Europe news	Internet Europe	Internet
c=Internet%20Germany%20news	Internet Germany news	Internet Germany	Internet
c=Internet%20Latin%20America%20news	Internet Latin America news	Internet Latin America	Internet
c=Internet%20consultancies%20news	Internet consultancies news	Internet consultancies	Internet
c=Internet%20telephony%20news	Internet telephony news	Internet telephony	Internet
c=Internet%3A%20international%20news	Internet: international news	Internet global	Internet
c=Iran%20news	Iran news	Iran	Regional
c=Iraq%20news	Iraq news	Iraq	Regional
c=Ireland%20news	Ireland news	Ireland	Regional
c=Israel%20news	Israel news	Israel	Regional
c=Italy%20news	Italy news	Italy	Regional
c=JP%20Morgan%20news	JP Morgan news	JP Morgan	Companies
c=Japan%20news	Japan news	Japan	Regional
c=Java%20news	Java news	Java	Technology
c=Jewish%20news	Jewish news	Jewish	Society
c=Job%20markets%20news	Job markets news	Job markets	Business: general
c=Johnson%20and%20Johnson%20news	Johnson and Johnson news	Johnson &amp; Johnson	Companies
c=Jokes	Jokes	Jokes	Entertainment
c=Journalism%20news	Journalism news	Journalism	Business: media
c=Knowledge%20management%20news	Knowledge management news	Knowledge management	Technology
c=Korea%20news	Korea news	Korea	Regional
c=LA%20news	LA news	LA	US regional
c=Latin%20America%20news	Latin America news	Latin America	Regional
c=Latino%20news	Latino news	Latino	Society
c=Law%20news	Law news	Law	Business: general
c=Leisure%20goods%20news	Leisure goods news	Leisure goods	Industry
c=Linux%20news	Linux news	Linux	Technology
c=Logistics%20news	Logistics news	Logistics	Industry
c=London%20news	London news	London	Regional
c=MP3%20news	MP3 news	MP3	Technology
c=Macintosh%20news	Macintosh news	Mac	Technology
c=Management%20news	Management news	Management	Business: general
c=Marketing%20news	Marketing news	Marketing	Business: general
c=McDonalds%20news	McDonalds news	McDonalds	Companies
c=Medical%20news	Medical news	Medical	Science
c=Merck%20and%20Co%20news	Merck and Co news	Merck &amp; Co	Companies
c=Mergers%20and%20acquisitions%20news	Mergers and acquisitions news	M and A	Finance
c=Metals%20industry%20news	Metals industry news	Metals	Industry
c=Mexico%20news	Mexico news	Mexico	Regional
c=Miami%2DFort%20Lauderdale%20news	Miami-Fort Lauderdale news	Miami-Fort Lauderdale	US regional
c=Microsoft%20news	Microsoft news	Microsoft	Companies
c=Mideast%20news	Mideast news	Mideast	Regional
c=Mining%20and%20metals%20news	Mining and metals news	Mining and metals	Industry
c=Minneapolis%2DSt%20Paul%20news	Minneapolis-St Paul news	Minneapolis-St Paul	US regional
c=Mobile%20industry%20news	Mobile industry news	Mobile	Technology
c=Mortgage%20industry%20news	Mortgage industry news	Mortgage	Industry
c=Movie%20business%20news	Movie business news	Movie business	Business: media
c=Music%20business%20news	Music business news	Music business	Business: media
c=Mutual%20funds%20news	Mutual funds news	Mutual funds	Finance
c=Nanotechnology%20news	Nanotechnology news	Nanotech	Science
c=New%20York%20City%20news	New York City news	New York	US regional
c=New%20Zealand%20news	New Zealand news	New Zealand	Regional
c=Newspaper%20publishing%20news	Newspaper publishing news	News publishing	Business: media
c=North%20Africa%20news	North Africa news	North Africa	Regional
c=OS%20news	OS news	OS	Technology
c=Obituaries	Obituaries	Obituaries	Society
c=Offbeat%20news	Offbeat news	Offbeat	Society
c=Oil%20and%20gas%20news	Oil and gas news	Oil and gas	Industry
c=Online%20access%20news	Online access news	Online access	Internet
c=Online%20auction%20news	Online auction news	Online auction	Internet
c=Online%20banking%20news	Online banking news	Online banking	Finance
c=Online%20broker%20news	Online broker news	Online broker	Finance
c=Online%20content%20news	Online content news	Online content	Internet
c=Online%20information%20news	Online information news	Online info.	Internet
c=Online%20legal%20issues%20news	Online legal issues news	Online legal issues	Internet
c=Online%20marketing%20news	Online marketing news	Online marketing	Internet
c=Online%20portals%20news	Online portals news	Online portals	Internet
c=Online%20search%20engines%20news	Online search engines news	Online search engines	Internet
c=Open%20source%20news	Open source news	Open source	Technology
c=Outsourcing%20news	Outsourcing news	Outsourcing news	Business: general
c=PC%20industry%20news	PC industry news	PC	Technology
c=PC%20software%20news	PC software news	PC software	Technology
c=Packaging%20and%20paper%20news	Packaging and paper news	Packaging	Industry
c=Pakistan%20news	Pakistan news	Pakistan	Regional
c=Personal%20data%20privacy%20news	Personal data privacy news	Personal data privacy	Society
c=Personal%20finance%20news	Personal finance news	Personal finance	Finance
c=Personal%20technology%20news	Personal technology news	Personal tech	Technology
c=Pharma%20industry%20news	Pharma industry news	Pharmaceutical	Industry
c=Philadelphia%20news	Philadelphia news	Philadephia	US regional
c=Philippines%20news	Philippines news	Philippines	Regional
c=Phoenix%20news	Phoenix news	Phoenix	US regional
c=Pittsburgh%20news	Pittsburgh news	Pittsburgh	US regional
c=Plastics%20industry%20news	Plastics industry news	Plastics	Industry
c=Poland%20news	Poland news	Poland	Regional
c=Police%20news	Police news	Police	Society
c=Pop%20music%20news	Pop music news	Pop music	Entertainment
c=Pop%20music%20reviews	Pop music reviews	Pop music reviews	Entertainment
c=Portland%2DSalem%20news	Portland-Salem news	Portland-Salem	US regional
c=Portugal%20news	Portugal news	Portugal	Regional
c=Procter%20and%20Gamble%20news	Procter and Gamble news	Procter &amp; Gamble	Companies
c=Public%20health%20news	Public health news	Public health	Science
c=RFID%20news	RFID news	RFID	Technology
c=RSS%20news	RSS news	RSS	Internet
c=Real%20estate%20news	Real estate news	Real estate	Industry
c=Religion%20news	Religion news	Religion	Society
c=Retail%20investor%20news	Retail investor news	Retail investor	Finance
c=Retail%20sector%20news	Retail sector news	Retail sector	Industry
c=Robotics%20news	Robotics news	Robotics	Technology
c=Russia%20news	Russia news	Russia	Regional
c=SBC%20Communications%20news	SBC Communications news	SBC Communications	Companies
c=San%20Diego%20news	San Diego news	San Diego	US regional
c=Satirical%20news	Satirical news	Satire	Entertainment
c=Saudi%20Arabia%20news	Saudi Arabia news	Saudi Arabia news	Regional
c=Scandinavia%20news	Scandinavia news	Scandinavia	Regional
c=Science%20news	Science news	Science: general	Science
c=Science%3A%20biological%20sciences%20news	Science: biological sciences news	Science: biological	Science
c=Science%3A%20human%20sciences%20news	Science: human sciences news	Science: human	Science
c=Science%3A%20physical%20sciences%20news	Science: physical sciences news	Science: physical	Science
c=Seattle%2DTacoma%20news	Seattle-Tacoma news	Seattle-Tacoma	US regional
c=Securities%20industry%20news	Securities industry news	Securities	Finance
c=Semiconductor%20industry%20news	Semiconductor industry news	Semiconductors	Technology
c=Shipping%20industry%20news	Shipping industry news	Shipping	Industry
c=Silicon%20Valley%20news	Silicon Valley news	Silicon Valley	US regional
c=Small%20business%20news	Small business news	Small business	Business: general
c=Software%20downloads	Software downloads	Software downloads	Internet
c=South%20Africa%20news	South Africa news	South Africa	Regional
c=Southeast%20Asia%20news	Southeast Asia news	Southeast Asia	Regional
c=Space%20science%20news	Space science news	Space science	Science
c=Spain%20news	Spain news	Spain	Regional
c=Sports%20business%20news	Sports business news	Sports business	Industry
c=Sports%3A%20American%20football%20news	Sports: American football news	Football (US)	Sports
c=Sports%3A%20Olympic%20sports%20news	Sports: Olympic sports news	Olympic sports	Sports
c=Sports%3A%20US%20college%20sports%20news	Sports: US college sports news	Sports: US college sports news	Sports
c=Sports%3A%20baseball%20news	Sports: baseball news	Baseball	Sports
c=Sports%3A%20basketball%20news	Sports: basketball news	Basketball	Sports
c=Sports%3A%20boxing%20news	Sports: boxing news	Boxing	Sports
c=Sports%3A%20cricket%20news	Sports: cricket news	Cricket	Sports
c=Sports%3A%20cycling%20news	Sports: cycling news	Cycling	Sports
c=Sports%3A%20golf%20news	Sports: golf news	Golf	Sports
c=Sports%3A%20horse%20racing%20news	Sports: horse racing news	Horse racing	Sports
c=Sports%3A%20ice%20hockey%20news	Sports: ice hockey news	Ice hockey	Sports
c=Sports%3A%20major%20league%20soccer%20news	Sports: major league soccer news	Major league soccer	Sports
c=Sports%3A%20motor%20sports%20news	Sports: motor sports news	Motor sports	Sports
c=Sports%3A%20rugby%20news	Sports: rugby news	Rugby	Sports
c=Sports%3A%20soccer%20news	Sports: soccer news	Football (soccer)	Sports
c=Sports%3A%20tennis%20news	Sports: tennis news	Tennis	Sports
c=Sports%3A%20top%20stories	Sports: top stories	Top sports	Top stories
c=Sports%3A%20wrestling%20news	Sports: wrestling news	Wrestling	Sports
c=Sports%3A%20yachting%20news	Sports: yachting news	Yachting	Sports
c=St%20Louis%20news	St Louis news	St Louis	US regional
c=Steelmaking%20news	Steelmaking news	Steelmaking	Industry
c=Stock%20Exchanges%20news	Stock Exchanges news	Stock Exchanges	Finance
c=Stockwatch	Stockwatch	Stockwatch	Finance
c=Sudan%20news	Sudan news	Sudan	Regional
c=Syria%20news	Syria news	Syria	Regional
c=Taiwan%20news	Taiwan news	Taiwan	Regional
c=Tampa%2DSt%20Petersburg%20news	Tampa-St Petersburg news	Tampa-St Petersburg	US regional
c=Tech%20events	Tech events	Tech events	Technology
c=Tech%20latest	Tech latest	Tech latest	Top stories
c=Tech%20policy%20news	Tech policy news	Tech policy	Technology
c=Tech%20stocks%20news	Tech stocks news	Tech stocks	Finance
c=Telecom%20news	Telecom news	Telecom	Technology
c=Textiles%20news	Textiles news	Textiles	Industry
c=Tobacco%20industry%20news	Tobacco industry news	Tobacco	Industry
c=Top%20Asia%2DPacific%20stories	Top Asia-Pacific stories	Top Asia-Pacific	Top stories
c=Top%20Europe%20stories	Top Europe stories	Top Europe	Top stories
c=Top%20UK%20stories	Top UK stories	Top UK	Top stories
c=Top%20US%20stories	Top US stories	Top US	Top stories
c=Top%20business%20stories	Top business stories	Top business	Top stories
c=Top%20finance%20stories	Top finance stories	Top finance	Top stories
c=Top%20internet%20stories	Top internet stories	Top internet	Top stories
c=Top%20media%20stories	Top media stories	Top media	Top stories
c=Top%20stories	Top stories	Top stories	Top stories
c=Top%20technology%20stories	Top technology stories	Top technology	Top stories
c=Trade%20news	Trade news	Trade	Society
c=Transportation%20industry%20news	Transportation industry news	Transportation	Industry
c=Travel%20industry%20news	Travel industry news	Travel	Industry
c=Turkey%20news	Turkey news	Turkey	Regional
c=UK%20black%20interest%20news	UK black interest news	UK black interest	Society
c=UK%20business%20news	UK business news	UK business	Business: general
c=UK%20education%20news	UK education news	UK education	Society
c=UK%20immigration%20news	UK immigration news	UK immigration	Society
c=UK%20law%20news	UK law news	UK law	Business: general
c=UK%20media%20news	UK media news	UK media	Business: media
c=UK%20medical%20news	UK medical news	UK medical	Science
c=UK%20news	UK news	UK	Regional
c=UK%20politics%20news	UK politics news	UK politics	Society
c=UK%20security%20news	UK security news	UK security	Society
c=UK%20tabloid%20news	UK tabloid news	Uk tabloid	Entertainment
c=US%20banking%20news	US banking news	Banking: US	Finance
c=US%20education%20news	US education news	US education	Society
c=US%20immigration%20news	US immigration news	US immigration	Society
c=US%20political%20columnists	US political columnists	Political columns	Society
c=US%20politics%20news	US politics news	US politics	Society
c=US%20security%20news	US security news	US security	Society
c=US%20social%20policy%20news	US social policy news	US social policy	Society
c=United%20Technologies%20news	United Technologies news	United Technologies	Companies
c=Utilities%20news	Utilities news	Utilities	Industry
c=Venture%20capital%20news	Venture capital news	Venture capital	Finance
c=Vertical%20portals%20news	Vertical portals news	Vertical portals	Internet
c=Videogame%20news	Videogame news	Videogames	Entertainment
c=Virus%20warnings	Virus warnings	Virus warnings	Technology
c=Wal%2DMart%20Stores%20news	Wal-Mart Stores news	Wal-Mart Stores	Companies
c=Walt%20Disney%20news	Walt Disney news	Walt Disney	Companies
c=Weather%20news	Weather news	Weather news	Science
c=Web%20developer%20news	Web developer news	Web developer	Internet
c=Web%20services%20news	Web services news	Web services	Internet
c=Webmaster%20tips	Webmaster tips	Webmaster tips	Internet
c=Website%20owner%20news	Website owner news	Website owner	Internet
c=Windows%20news	Windows news	Windows news	Technology
c=Wireless%20sector%20news	Wireless sector news	Wireless sector	Technology
c=Womens%20rights%20news	Womens rights news	Womens rights	Society
c=XML%20and%20metadata%20news	XML and metadata news	XML and metadata	Internet
c=Zimbabwe%20news	Zimbabwe news	Zimbabwe	Regional